####################################
#S         #########################
#####  ### #########################
###### ###   #######################
#####  ####     ####################
###########  ## ##  ################
##########  ###  #   #### ##########
########## ####  ##       ##########
##########  ####   E################
####################################
